-b-b-*-*-b-b-b-bsb-b-
b-b-b-b-b-b-*-b-*-b-b
-b-*-*-*-*-b-*-*-b-b-
b-b-b-*-*-*-*-*-b-b-b
-b-*-*-*-*-*-*-b-b-b-
b-*-*-b-b-b-*-*-*-b-b
-*-*-b-*-*-*-*-b-*-b-
*-*-*-b-b-b-b-b-*-b-b
-*-*-*-*-*-*-*-*-b-b-
b-*-*-b-b-b-*-b-*-b-b
-b-*-*-*-*-b-*-bsb-b-
b-*-*-b-*-b-*-b-b-b-b
-b-*-b-*-*-b-*-b-b-b-
