-b-b-*-*-b-b-b-
b-b-b-*-*-*-*-b
-bs*-*-*-*-bs*-
b-b-b-b-b-b-*-b
-bs*-*-*-*-bs*-
