-b-b-*-*-b-b-b-
b-b-b-*-*-*-*-b
-bs*-*-*-*-b-*-
b-b-b-b-b-b-*-b
-b-*-*-*-*-bs*-
