-*s*-*-*-*-b-*-
b-b-b-*-*-*-*-*
-*-*-*-*-*-*-*-
b-*-*-*-b-b-*-b
-b-*-*-*-*-*-*-
*-b-b-*-*-*-*-*
-*-b-*-*-*-b-*-
*-*-*-*-*-b-*b
-*-b-*-*-b-*-b-
*-*-*-*-*-*-*-*
-*-*-*-b-*-*-b-
b-*-*-b-*-b-*-*
-*-b-*-b-*-*-*-
*-*-*-*-*-*-*-b
-*-b-*-b-*-*-*-
*-*-*-*-b-*-b-*
-*-b-*-b-*-*-s-